R 192  1 8 
C 255,255,255

               1
              1 1
             1   111111111111111111111
            1     11111111111111000000         1
            1     000000000000000000001
            1     11111111111111
             1   1
              1 1
              1 1
111111111111111 11111111
1      1111111   1111111
1      11             11
1  N   11 1111   1111 11
1      11 1111   1111 11
1      11 1111   1111 11
1      11 1111   1111 11
1      1               1
111  111               1
111  111               1
1      1               1
1      1        9      1
1                      1
1      1               1
1      1               1
1      1               1
1      1111111    111111
111  111111111    111111
111  111               1
111  111               1
1      1               1
1      1               1
1      1               1
1                      1
1      1               1
1      1               1
1      1               1
111111111111111111111111
