R 800 800
C 255,255,2
F 69,69,69

NO  pics/NO.xpm
SO  pics/SO.xpm
EA  pics/EA.xpm
WE  pics/WE.xpm
S   pics/small_shrek.xpm


11111111       1
1      1      1 1
1      1     1   1
1      1    1     1
1  0   1   1       1
1      1    1     1
1      1     1   1
1      1      1 1
1      1      1 1
1 1111 11111111 11111111
1      1111111   1111111
1      11             11
1      11 1111   1111 11
1      11 1111   1111 11
1      11 1111   1111 11
1      11 1111   1111 11
1      1        2   1  1
111  111   1    1   2  1
111  111   1    2   2  1
1      1   1        2  1
1      1   0    0   0  1
1          1        2  1
1      1   1   212  2  1
1      1   1        2  1
1      1            1  1
1      1111111    111111
111  111111111    111111
111  111               1
111  111               1
1      1               1
1      1               1
1      1               1
1   0                  1
1      1               1
1      1               1
1      1               1
111111111111111111111  1
                    1  1
                    1  1
                    1  111111111111111111111111111111111111111111111111111111111111111111111111111111111
                    1 W                                                                                1
                    111111111111111111111111111111111111111111111111                                   1
                                                                   1                                   1
                                                                   1                                   1
                                                                   1                                   1
                                                                   1                                   1
                                                                   1                                   1
                                                                   1                                   1
                                                                   1                                   1
                                                                   1                                   1
                                                                   1                                   1
                                                                   1                                   1
                                                                   1                                   1
                                                                   1                                   1
                                                                   1                                   1
                                                                   1111111111111111111111111111111111111
                                                                    
 
 
