R 800 800
C 255,255,2
F 69,69,69

NO  pics/NO.xpm
SO  pics/SO.xpm
EA  pics/EA.xpm
WE  pics/WE.xpm
S   pics/small_shrek.xpm

111111111
100000001
100000001
1000N0001
100000001
100000001
111111111




