R 1000 1000
C 0,0,0
F 69,69,69

NO  pics/NO.xpm
SO  pics/SO.xpm
EA  pics/EA.xpm
WE  pics/WE.xpm
S   pics/small_shrek.xpm
S2	pics/64x64.xpm
EN  pics/wtc_bigger.xpm


11111111111111111111111111111111111111111
111111111111040404040400400000000000000011
11111111111000000000000000000000000000000111
111111111100000000000000000000000000000000111
1111111110000000000400000000000000000000000011
1111111110000400000000000000001000000000000011
1111111100000000000000000000010000000000000001
1111111100400000004000000040100040000400000011
1111111100000040000000400001000000000400000011
11111111000000000040000000100040000004000000111
1111111100000400000000111111111111000000000001111111111111111111111111111111111111111111
1111111100400000000000140000000041040000000000000004000000000000400000000000100000011
11111111100000000000010000004000401000000004000000000000000000000000000000000100E0001111
11111111110000000000100000000000000100000000000000000000000000000000000000000000000001
1111111111100000000000000004000000400000000001111111111111111111111111111111111111111111111
1111111111110000000000000000000000000000400001
11111111111104040404040400000000040000000400001
111111111111111111111111111111111111111111111111
