R 800 800
C 255,0,0
F 69,69,69

NO	pics/brick.xpm
SO	pics/brick.xpm
EA	pics/brick.xpm
WE	pics/brick.xpm
S	pics/burger.xpm
S2	pics/64x64.xpm
EN	pics/zombie.xpm


11111111111111111111111111111111111111111
111111111111040404040400400000000000000011
111111111114000000000000000000020000000001111111111111111111111111111111111111111
114411111140000000000020000000000000200000000000000000000000000000000000000000001
114411111400000000040000000000000000000000011111111111111110111111111111111111101
11441111140004000000000000000010000020000000111           141                 101
11141111400000400000200000000100000000000000001           141                 101
11441111004000000040000000401000400004004000001           141                 101
11440000004000400000004000010000000000004004001           141                 101
114411114000000040400000001000400000040000000011          141                 101
111411114000040000000011111111111100000004000001111111111110111111111111111111101111111111
1144111100400002000000140000000041040000000000000004000000000000400000000000100000011
11441111100002000000010000004000401000000000000000000200000000000000000000000100E0001111
11441111110000000000100000000000000100400000000000000002000000000000000000000000002001
11111111111000000000000000040000004000000000001111111111111111111111111111111111111111111111
11111111111100000000000000000000000040004000011
11111111111104040404040400000000040000400400001
111111111111111111111111111111111111111111111111
