R 1920 1080
F 100,100,100
C 0,0,1

NO  pics/NO.xpm
SO  pics/SO.xpm
EA  pics/EA.xpm
WE  pics/WE.xpm

1111111111111111111111111111111111111111111111111111111111111
1222222222222222222222222222222222222222222222222222222222221
1200000000000000000000000000000000000000000000000000000000021
1200000000000000000000000000000000000000000000000000000000021
1200000000000000000000000000000000000000000000000000000000021
1200000000000000000000000000000000000000000000000000000000021
1200000000000000000000000000000000000000000000000000000000021
1200000000000000000000000000000000000000000000000000000000021
1200000000000000000000000000000000000000000000000000000000021
1200000000000000000000000000000000000000000000000000000000021
1200000000000000000000000000000000000000000000000000000000021
1200000000000000000000000000000000000000000000000000000000021
1200000000000000000000000000000000000000000000000000000000021
1200000000000000000000000000000000000000000000000000000000021
120000000000000000000000000000N000000000000000000000000000021
1200000000000000000000000000000000000000000000000000000000021
1200000000000000000000000000000000000000000000000000000000021
1200000000000000000000000000000000000000000000000000000000021
1200000000000000000000000000000000000000000000000000000000021
1200000000000000000000000000000000000000000000000000000000021
1200000000000000000000000000000000000000000000000000000000021
1200000000000000000000000000000000000000000000000000000000021
1200000000000000000000000000000000000000000000000000000000021
1200000000000000000000000000000000000000000000000000000000021
1200000000000000000000000000000000000000000000000000000000021
1222222222222222222222222222222222222222222222222222222222221
1111111111111111111111111111111111111111111111111111111111111
